2 2 2 2 2 2 2 2 2 2
2 3 3 2 3 3 3 3 2 2
2 3 3 3 3 3 3 3 3 2
2 3 3 3 3 3 3 3 3 2
2 3 3 3 2 3 3 3 3 2
2 3 3 3 2 3 3 3 3 2
2 3 3 3 3 3 3 3 2 2
2 3 3 4 6 5 3 3 3 2
2 3 3 3 2 2 3 3 3 2
2 2 2 2 2 2 2 2 2 2
