2 2 2 2 2 2 2 2 2 2
2 2 2 2 3 3 3 3 2 2
2 2 4 3 6 2 2 3 2 2
2 4 4 6 3 6 3 3 5 2
2 4 4 3 6 3 6 3 2 2
2 2 2 2 2 2 3 3 2 2
2 2 2 2 2 2 2 2 2 2