2 2 2 2 2 2 2 2 2 2
2 5 3 2 3 3 3 4 2 2
2 4 3 3 3 3 3 3 3 2
2 3 3 3 2 6 3 3 3 2
2 3 3 3 2 3 3 6 3 2
2 3 3 3 2 3 3 3 3 2
2 3 3 3 3 3 3 3 2 2
2 3 6 3 3 3 3 3 3 2
2 3 3 3 2 2 3 3 4 2
2 2 2 2 2 2 2 2 2 2
