2 2 2 2 2 2 2 2 2 2
2 3 3 2 3 3 3 3 2 2
2 3 3 3 3 3 3 3 3 2
2 4 3 6 5 6 3 3 3 2
2 3 3 3 2 3 3 3 3 2
2 3 3 3 2 3 3 3 3 2
2 4 3 3 3 3 4 6 2 2
2 3 3 4 6 3 3 3 3 2
2 3 3 3 2 2 3 3 3 2
2 2 2 2 2 2 2 2 2 2
