1 1 1 1 1 1 1 1 2 2 2 2 2 1 1 1 1
1 1 1 1 1 1 1 1 2 3 3 3 2 2 2 2 2
1 1 1 1 1 1 1 1 2 3 2 6 2 2 3 3 2
1 1 1 1 1 1 1 1 2 3 3 3 3 3 6 3 2
2 2 2 2 2 2 2 2 2 3 2 2 2 3 3 3 2
2 4 4 4 4 3 3 2 2 3 6 3 3 6 2 2 2
2 4 4 4 4 3 3 3 3 6 3 6 6 3 2 2 1
2 4 4 4 4 3 3 2 2 6 3 3 6 5 3 2 1
2 2 2 2 2 2 2 2 2 3 3 6 3 3 2 2 1
1 1 1 1 1 1 1 1 2 3 6 3 6 3 3 2 1
1 1 1 1 1 1 1 1 2 2 2 3 2 2 3 2 1
1 1 1 1 1 1 1 1 1 1 2 3 3 3 3 2 1
1 1 1 1 1 1 1 1 1 1 2 2 2 2 2 2 1